County,ZIP Code,Year,New,Renewed,Insured-Initiated Nonrenewed,Insurer-Initiated Nonrenewed,Non-Renewed,Active
Napa,94503,2017,547,4812,407.0,105.0,512,5359
Napa,94508,2017,55,718,58.0,19.0,77,773
Solano,94510,2017,663,7598,579.0,95.0,674,8261
Solano,94512,2017,14,15,1.0,1.0,2,29
Napa,94515,2017,204,2022,164.0,46.0,210,2226
Solano,94533,2017,2033,15916,1577.0,278.0,1855,17949
Solano,94534,2017,1390,11038,1084.0,118.0,1202,12428
Solano,94535,2017,3,10,2.0,0.0,2,13
Napa,94558,2017,1847,17825,1477.0,357.0,1834,19672
Napa,94559,2017,745,6378,524.0,163.0,687,7123
Napa,94562,2017,4,20,1.0,0.0,1,24
Napa,94567,2017,35,138,17.0,9.0,26,173
Solano,94571,2017,681,3872,513.0,53.0,566,4553
Napa,94573,2017,5,50,3.0,0.0,3,55
Napa,94574,2017,269,2454,217.0,64.0,281,2723
Napa,94576,2017,7,62,2.0,2.0,4,69
Solano,94585,2017,898,7557,776.0,101.0,877,8455
Solano,94591,2017,1762,14706,1465.0,270.0,1735,16468
Napa,94599,2017,106,794,83.0,19.0,102,900
Sonoma,95401,2017,912,8310,723.0,147.0,870,9222
Sonoma,95403,2017,1152,10035,950.0,292.0,1242,11187
Sonoma,95404,2017,1330,11222,1058.0,351.0,1409,12552
Sonoma,95405,2017,646,6221,500.0,119.0,619,6867
Sonoma,95409,2017,999,8153,760.0,141.0,901,9152
Sonoma,95412,2017,3,81,3.0,0.0,3,84
Sonoma,95416,2017,2,13,1.0,0.0,1,15
Sonoma,95419,2017,20,228,18.0,7.0,25,248
Sonoma,95421,2017,74,714,44.0,23.0,67,788
Lake,95422,2017,723,4154,495.0,220.0,715,4877
Lake,95423,2017,262,1707,185.0,77.0,262,1969
Lake,95424,2017,15,155,18.0,5.0,23,170
Sonoma,95425,2017,353,3101,270.0,57.0,327,3454
Lake,95426,2017,98,706,105.0,55.0,160,804
Sonoma,95430,2017,10,70,7.0,2.0,9,80
Sonoma,95433,2017,4,47,3.0,3.0,6,51
Sonoma,95436,2017,258,2112,173.0,84.0,257,2370
Sonoma,95439,2017,13,157,17.0,4.0,21,170
Sonoma,95441,2017,35,433,25.0,13.0,38,468
Sonoma,95442,2017,117,1154,89.0,30.0,119,1271
Sonoma,95444,2017,11,240,12.0,3.0,15,251
Mendocino,95445,2017,105,1035,82.0,35.0,117,1140
Sonoma,95446,2017,333,2436,212.0,108.0,320,2769
Sonoma,95448,2017,535,4902,419.0,95.0,514,5437
Mendocino,95449,2017,29,249,18.0,7.0,25,278
Sonoma,95450,2017,29,248,17.0,12.0,29,277
Lake,95451,2017,529,3924,373.0,176.0,549,4453
Sonoma,95452,2017,48,625,54.0,12.0,66,673
Lake,95457,2017,132,944,119.0,70.0,189,1076
Lake,95461,2017,142,914,120.0,52.0,172,1056
Sonoma,95462,2017,105,784,75.0,44.0,119,889
Sonoma,95465,2017,48,554,35.0,19.0,54,602
Lake,95467,2017,348,2097,255.0,83.0,338,2445
Sonoma,95471,2017,13,162,12.0,1.0,13,175
Sonoma,95472,2017,784,8769,550.0,173.0,723,9553
Sonoma,95476,2017,1137,10620,888.0,195.0,1083,11757
Sonoma,95486,2017,6,69,4.0,5.0,9,75
Sonoma,95492,2017,852,7864,694.0,135.0,829,8716
Sonoma,95497,2017,189,1349,162.0,37.0,199,1538
Yolo,95606,2017,5,26,3.0,0.0,3,31
Yolo,95607,2017,14,59,5.0,3.0,8,73
Yolo,95616,2017,723,8373,606.0,97.0,703,9096
Solano,95620,2017,600,4810,428.0,82.0,510,5410
Solano,95625,2017,5,65,5.0,2.0,7,70
Yolo,95627,2017,101,851,71.0,29.0,100,952
Yolo,95637,2017,11,73,10.0,2.0,12,84
Yolo,95653,2017,8,118,6.0,1.0,7,126
Yolo,95679,2017,7,14,3.0,0.0,3,21
Solano,95687,2017,1979,15827,1572.0,184.0,1756,17806
Solano,95688,2017,1202,10512,991.0,128.0,1119,11714
Yolo,95694,2017,228,2070,136.0,32.0,168,2298
Yolo,95695,2017,955,8579,786.0,183.0,969,9534
Yolo,95697,2017,4,57,3.0,4.0,7,61
Yolo,95698,2017,3,53,3.0,3.0,6,56
Colusa,95912,2017,129,917,95.0,32.0,127,1046
Colusa,95932,2017,198,1732,161.0,70.0,231,1930
Yolo,95937,2017,32,311,22.0,8.0,30,343
Colusa,95979,2017,26,212,13.0,9.0,22,238
Colusa,95987,2017,170,1067,118.0,44.0,162,1237
Napa,94503,2018,636,4847,547.0,85.0,632,5483
Napa,94508,2018,74,692,58.0,16.0,74,766
Solano,94510,2018,703,7613,589.0,72.0,661,8316
Solano,94512,2018,0,11,2.0,0.0,2,11
Napa,94515,2018,239,1985,190.0,40.0,230,2224
Solano,94533,2018,1930,15831,1621.0,289.0,1910,17761
Solano,94534,2018,1620,11236,1226.0,156.0,1382,12856
Solano,94535,2018,1,8,1.0,0.0,1,9
Napa,94558,2018,1878,17833,1593.0,285.0,1878,19711
Napa,94559,2018,702,6473,597.0,98.0,695,7175
Napa,94562,2018,0,21,1.0,0.0,1,21
Napa,94567,2018,9,127,9.0,7.0,16,136
Solano,94571,2018,755,3990,477.0,59.0,536,4745
Napa,94573,2018,3,50,3.0,0.0,3,53
Napa,94574,2018,309,2452,234.0,45.0,279,2761
Napa,94576,2018,7,56,5.0,1.0,6,63
Solano,94585,2018,812,7571,719.0,100.0,819,8383
Solano,94591,2018,1792,14627,1490.0,207.0,1697,16419
Napa,94599,2018,114,788,87.0,17.0,104,902
Sonoma,95401,2018,963,8362,806.0,126.0,932,9325
Sonoma,95403,2018,1279,9711,1350.0,208.0,1558,10990
Sonoma,95404,2018,1302,11016,1284.0,204.0,1488,12318
Sonoma,95405,2018,717,6185,624.0,80.0,704,6902
Sonoma,95409,2018,1105,8163,848.0,151.0,999,9268
Sonoma,95412,2018,3,81,2.0,1.0,3,84
Sonoma,95416,2018,2,11,2.0,0.0,2,13
Sonoma,95419,2018,18,223,11.0,8.0,19,241
Sonoma,95421,2018,72,705,49.0,28.0,77,777
Lake,95422,2018,755,4430,504.0,226.0,730,5185
Lake,95423,2018,311,1743,208.0,71.0,279,2054
Lake,95424,2018,13,144,16.0,3.0,19,157
Sonoma,95425,2018,359,3153,272.0,60.0,332,3512
Lake,95426,2018,90,629,53.0,20.0,73,719
Sonoma,95430,2018,5,69,2.0,1.0,3,74
Sonoma,95433,2018,4,47,4.0,2.0,6,51
Sonoma,95436,2018,262,2099,198.0,64.0,262,2361
Sonoma,95439,2018,18,160,13.0,5.0,18,178
Sonoma,95441,2018,41,429,29.0,11.0,40,470
Sonoma,95442,2018,110,1136,113.0,23.0,136,1246
Sonoma,95444,2018,23,230,12.0,3.0,15,253
Mendocino,95445,2018,113,1014,86.0,30.0,116,1127
Sonoma,95446,2018,323,2415,221.0,108.0,329,2738
Sonoma,95448,2018,570,4910,459.0,93.0,552,5480
Mendocino,95449,2018,40,256,21.0,6.0,27,296
Sonoma,95450,2018,25,243,22.0,11.0,33,268
Lake,95451,2018,534,3891,399.0,162.0,561,4425
Sonoma,95452,2018,50,613,51.0,13.0,64,663
Lake,95457,2018,170,981,91.0,50.0,141,1151
Lake,95461,2018,150,925,86.0,30.0,116,1075
Sonoma,95462,2018,91,787,61.0,26.0,87,878
Sonoma,95465,2018,61,556,35.0,11.0,46,617
Lake,95467,2018,361,2110,254.0,60.0,314,2471
Sonoma,95471,2018,5,151,9.0,4.0,13,156
Sonoma,95472,2018,948,8837,711.0,180.0,891,9785
Sonoma,95476,2018,1260,10610,1027.0,173.0,1200,11870
Sonoma,95486,2018,4,61,6.0,1.0,7,65
Sonoma,95492,2018,882,7884,774.0,112.0,886,8766
Sonoma,95497,2018,164,1310,132.0,28.0,160,1474
Yolo,95606,2018,3,31,1.0,0.0,1,34
Yolo,95607,2018,6,65,4.0,2.0,6,71
Yolo,95616,2018,797,8184,665.0,68.0,733,8981
Solano,95620,2018,644,4855,489.0,55.0,544,5499
Solano,95625,2018,4,61,6.0,1.0,7,65
Yolo,95627,2018,110,836,70.0,26.0,96,946
Yolo,95637,2018,8,77,4.0,2.0,6,85
Yolo,95653,2018,10,113,8.0,1.0,9,123
Yolo,95679,2018,0,15,1.0,1.0,2,15
Solano,95687,2018,2002,15930,1613.0,190.0,1803,17932
Solano,95688,2018,1171,10507,1002.0,116.0,1118,11678
Yolo,95694,2018,218,2100,189.0,32.0,221,2318
Yolo,95695,2018,915,8527,746.0,164.0,910,9442
Yolo,95697,2018,4,57,5.0,0.0,5,61
Yolo,95698,2018,1,53,2.0,2.0,4,54
Colusa,95912,2018,118,907,96.0,23.0,119,1025
Colusa,95932,2018,219,1700,160.0,64.0,224,1919
Yolo,95937,2018,42,273,31.0,13.0,44,315
Colusa,95979,2018,24,222,13.0,4.0,17,246
Colusa,95987,2018,167,1094,114.0,27.0,141,1261
Napa,94503,2019,580,4895,457.0,77.0,534,5475
Napa,94508,2019,85,669,51.0,37.0,88,754
Solano,94510,2019,740,7610,642.0,76.0,718,8350
Solano,94512,2019,0,28,14.0,2.0,16,28
Napa,94515,2019,258,1951,204.0,70.0,274,2209
Solano,94533,2019,2294,15834,1708.0,268.0,1976,18128
Solano,94534,2019,1501,11469,1167.0,196.0,1363,12970
Solano,94535,2019,0,6,8.0,2.0,10,6
Napa,94558,2019,1961,17732,1515.0,317.0,1832,19693
Napa,94559,2019,732,6484,529.0,97.0,626,7216
Napa,94562,2019,2,18,3.0,0.0,3,20
Napa,94567,2019,30,118,12.0,8.0,20,148
Solano,94571,2019,929,4127,480.0,76.0,556,5056
Napa,94573,2019,1,43,2.0,1.0,3,44
Napa,94574,2019,318,2429,226.0,94.0,320,2747
Napa,94576,2019,5,50,8.0,2.0,10,55
Solano,94585,2019,816,7534,671.0,109.0,780,8350
Solano,94591,2019,1715,14812,1344.0,211.0,1555,16527
Napa,94599,2019,94,794,80.0,17.0,97,888
Sonoma,95401,2019,927,8443,734.0,92.0,826,9370
Sonoma,95403,2019,1359,9497,1064.0,159.0,1223,10856
Sonoma,95404,2019,1331,10737,1064.0,271.0,1335,12068
Sonoma,95405,2019,601,6204,506.0,88.0,594,6805
Sonoma,95409,2019,1018,8228,744.0,179.0,923,9246
Sonoma,95412,2019,9,77,3.0,3.0,6,86
Sonoma,95416,2019,3,11,2.0,0.0,2,14
Sonoma,95419,2019,45,224,18.0,14.0,32,269
Sonoma,95421,2019,107,688,52.0,44.0,96,795
Lake,95422,2019,751,4362,488.0,242.0,730,5113
Lake,95423,2019,272,1778,169.0,78.0,247,2050
Lake,95424,2019,18,136,13.0,4.0,17,154
Sonoma,95425,2019,379,3119,288.0,66.0,354,3498
Lake,95426,2019,170,645,73.0,69.0,142,815
Sonoma,95430,2019,3,69,8.0,3.0,11,72
Sonoma,95433,2019,2,43,4.0,1.0,5,45
Sonoma,95436,2019,256,2097,165.0,91.0,256,2353
Sonoma,95439,2019,10,163,9.0,1.0,10,173
Sonoma,95441,2019,46,424,31.0,12.0,43,470
Sonoma,95442,2019,158,1091,81.0,51.0,132,1249
Sonoma,95444,2019,24,239,19.0,6.0,25,263
Mendocino,95445,2019,191,956,73.0,65.0,138,1147
Sonoma,95446,2019,370,2399,223.0,125.0,348,2769
Sonoma,95448,2019,594,4888,408.0,111.0,519,5482
Mendocino,95449,2019,29,259,23.0,9.0,32,288
Sonoma,95450,2019,41,241,24.0,8.0,32,282
Lake,95451,2019,757,3709,354.0,301.0,655,4466
Sonoma,95452,2019,66,593,45.0,16.0,61,659
Lake,95457,2019,192,968,85.0,73.0,158,1160
Lake,95461,2019,178,915,93.0,58.0,151,1093
Sonoma,95462,2019,115,789,65.0,38.0,103,904
Sonoma,95465,2019,62,564,35.0,15.0,50,626
Lake,95467,2019,403,2093,232.0,118.0,350,2496
Sonoma,95471,2019,8,145,15.0,5.0,20,153
Sonoma,95472,2019,888,8921,620.0,171.0,791,9809
Sonoma,95476,2019,1194,10663,943.0,193.0,1136,11857
Sonoma,95486,2019,8,51,14.0,8.0,22,59
Sonoma,95492,2019,847,8099,704.0,74.0,778,8946
Sonoma,95497,2019,224,1163,135.0,34.0,169,1387
Yolo,95606,2019,5,33,11.0,4.0,15,38
Yolo,95607,2019,8,64,6.0,1.0,7,72
Yolo,95616,2019,710,8298,641.0,63.0,704,9008
Solano,95620,2019,623,4941,460.0,76.0,536,5564
Solano,95625,2019,18,55,16.0,4.0,20,73
Yolo,95627,2019,105,865,72.0,22.0,94,970
Yolo,95637,2019,14,69,11.0,1.0,12,83
Yolo,95653,2019,12,113,7.0,3.0,10,125
Yolo,95679,2019,5,15,1.0,2.0,3,20
Solano,95687,2019,1993,16149,1660.0,201.0,1861,18142
Solano,95688,2019,1335,10499,998.0,158.0,1156,11834
Yolo,95694,2019,286,2076,177.0,52.0,229,2362
Yolo,95695,2019,927,8564,746.0,157.0,903,9491
Yolo,95697,2019,9,58,3.0,5.0,8,67
Yolo,95698,2019,4,51,2.0,1.0,3,55
Colusa,95912,2019,120,898,96.0,19.0,115,1018
Colusa,95932,2019,216,1719,169.0,52.0,221,1935
Yolo,95937,2019,52,296,32.0,19.0,51,348
Colusa,95979,2019,22,217,15.0,6.0,21,239
Colusa,95987,2019,159,1117,104.0,27.0,131,1276
Napa,94503,2020,538,4916,483.0,51.0,534,5454
Napa,94508,2020,65,694,50.0,10.0,60,759
Solano,94510,2020,695,7618,658.0,71.0,729,8313
Solano,94512,2020,5,23,3.0,1.0,4,28
Napa,94515,2020,289,1979,188.0,59.0,247,2268
Solano,94533,2020,2165,16157,1668.0,271.0,1939,18322
Solano,94534,2020,1412,11633,1156.0,170.0,1326,13045
Solano,94535,2020,0,8,1.0,0.0,1,8
Napa,94558,2020,1798,17904,1531.0,256.0,1787,19702
Napa,94559,2020,674,6603,578.0,68.0,646,7277
Napa,94562,2020,0,16,0.0,1.0,1,16
Napa,94567,2020,22,140,6.0,5.0,11,162
Solano,94571,2020,664,4442,546.0,58.0,604,5106
Napa,94573,2020,4,37,3.0,4.0,7,41
Napa,94574,2020,287,2487,241.0,35.0,276,2774
Napa,94576,2020,2,67,4.0,1.0,5,69
Solano,94585,2020,859,7507,745.0,102.0,847,8366
Solano,94591,2020,1598,14848,1417.0,190.0,1607,16446
Napa,94599,2020,105,786,90.0,10.0,100,891
Sonoma,95401,2020,826,8521,699.0,91.0,790,9347
Sonoma,95403,2020,1315,9664,978.0,143.0,1121,10979
Sonoma,95404,2020,1295,10738,1007.0,218.0,1225,12033
Sonoma,95405,2020,596,6256,509.0,99.0,608,6852
Sonoma,95409,2020,959,8396,795.0,110.0,905,9355
Sonoma,95412,2020,61,235,51.0,9.0,60,296
Sonoma,95416,2020,4,13,1.0,0.0,1,17
Sonoma,95419,2020,32,223,16.0,16.0,32,255
Sonoma,95421,2020,66,737,51.0,23.0,74,803
Lake,95422,2020,667,4447,536.0,208.0,744,5114
Lake,95423,2020,278,1804,219.0,66.0,285,2082
Lake,95424,2020,7,115,17.0,6.0,23,122
Sonoma,95425,2020,361,3147,289.0,57.0,346,3508
Lake,95426,2020,84,668,73.0,25.0,98,752
Sonoma,95430,2020,3,63,2.0,1.0,3,66
Sonoma,95433,2020,2,39,3.0,1.0,4,41
Sonoma,95436,2020,228,2169,176.0,50.0,226,2397
Sonoma,95439,2020,16,199,5.0,5.0,10,215
Sonoma,95441,2020,54,417,30.0,9.0,39,471
Sonoma,95442,2020,140,1126,118.0,32.0,150,1266
Sonoma,95444,2020,31,254,17.0,3.0,20,285
Mendocino,95445,2020,139,1040,106.0,34.0,140,1179
Sonoma,95446,2020,353,2568,227.0,80.0,307,2921
Sonoma,95448,2020,529,5023,400.0,116.0,516,5552
Mendocino,95449,2020,46,268,34.0,4.0,38,314
Sonoma,95450,2020,37,250,30.0,9.0,39,287
Lake,95451,2020,687,4010,540.0,121.0,661,4697
Sonoma,95452,2020,63,601,57.0,7.0,64,664
Lake,95457,2020,119,1040,108.0,27.0,135,1159
Lake,95461,2020,120,1003,89.0,23.0,112,1123
Sonoma,95462,2020,109,813,101.0,42.0,143,922
Sonoma,95465,2020,67,576,48.0,20.0,68,643
Lake,95467,2020,332,2187,255.0,57.0,312,2519
Sonoma,95471,2020,18,105,12.0,14.0,26,123
Sonoma,95472,2020,939,9067,691.0,188.0,879,10006
Sonoma,95476,2020,1272,10739,1071.0,196.0,1267,12011
Sonoma,95486,2020,3,53,1.0,1.0,2,56
Sonoma,95492,2020,826,8149,702.0,122.0,824,8975
Sonoma,95497,2020,171,1114,134.0,24.0,158,1285
Yolo,95606,2020,7,30,4.0,2.0,6,37
Yolo,95607,2020,10,58,13.0,3.0,16,68
Yolo,95616,2020,650,8284,594.0,58.0,652,8934
Solano,95620,2020,750,5008,545.0,67.0,612,5758
Solano,95625,2020,11,46,10.0,1.0,11,57
Yolo,95627,2020,78,869,78.0,16.0,94,947
Yolo,95637,2020,19,72,11.0,6.0,17,91
Yolo,95653,2020,12,103,10.0,2.0,12,115
Yolo,95679,2020,4,12,2.0,1.0,3,16
Solano,95687,2020,2254,16292,1754.0,178.0,1932,18546
Solano,95688,2020,1404,10577,1137.0,169.0,1306,11981
Yolo,95694,2020,322,2149,180.0,52.0,232,2471
Yolo,95695,2020,852,8644,707.0,129.0,836,9496
Yolo,95697,2020,11,65,4.0,2.0,6,76
Yolo,95698,2020,5,47,3.0,0.0,3,52
Colusa,95912,2020,152,959,115.0,25.0,140,1111
Colusa,95932,2020,239,1708,172.0,47.0,219,1947
Yolo,95937,2020,34,259,20.0,3.0,23,293
Colusa,95979,2020,28,235,24.0,3.0,27,263
Colusa,95987,2020,135,1162,97.0,22.0,119,1297
Napa,94503,2021,557,4868,488.0,88.0,576,5425
Napa,94508,2021,86,667,88.0,35.0,123,753
Solano,94510,2021,793,7505,743.0,101.0,844,8298
Solano,94512,2021,4,25,3.0,1.0,4,29
Napa,94515,2021,263,1999,203.0,54.0,257,2262
Solano,94533,2021,2388,16222,1885.0,304.0,2189,18610
Solano,94534,2021,1699,11546,1450.0,252.0,1702,13245
Solano,94535,2021,0,6,1.0,0.0,1,6
Napa,94558,2021,1991,17755,1728.0,337.0,2065,19746
Napa,94559,2021,760,6524,696.0,106.0,802,7284
Napa,94562,2021,2,11,1.0,2.0,3,13
Napa,94567,2021,20,142,15.0,4.0,19,162
Solano,94571,2021,1049,4602,612.0,76.0,688,5651
Napa,94573,2021,2,34,5.0,0.0,5,36
Napa,94574,2021,308,2427,292.0,80.0,372,2735
Napa,94576,2021,6,49,9.0,1.0,10,55
Solano,94585,2021,1002,7488,853.0,143.0,996,8490
Solano,94591,2021,1900,14582,1658.0,258.0,1916,16482
Napa,94599,2021,104,787,87.0,28.0,115,891
Sonoma,95401,2021,1142,8588,858.0,146.0,1004,9730
Sonoma,95403,2021,1484,9791,1023.0,199.0,1222,11275
Sonoma,95404,2021,1368,10735,1201.0,263.0,1464,12103
Sonoma,95405,2021,658,6211,611.0,87.0,698,6869
Sonoma,95409,2021,1245,8297,1064.0,157.0,1221,9542
Sonoma,95412,2021,17,243,51.0,10.0,61,260
Sonoma,95416,2021,2,11,4.0,0.0,4,13
Sonoma,95419,2021,62,214,38.0,19.0,57,276
Sonoma,95421,2021,98,720,52.0,40.0,92,818
Lake,95422,2021,604,4401,588.0,159.0,747,5005
Lake,95423,2021,283,1795,254.0,66.0,320,2078
Lake,95424,2021,5,124,10.0,1.0,11,129
Sonoma,95425,2021,433,3140,343.0,85.0,428,3573
Lake,95426,2021,82,650,53.0,32.0,85,732
Sonoma,95430,2021,2,61,3.0,0.0,3,63
Sonoma,95433,2021,3,42,3.0,0.0,3,45
Sonoma,95436,2021,285,2146,217.0,100.0,317,2431
Sonoma,95439,2021,14,203,15.0,3.0,18,217
Sonoma,95441,2021,79,434,47.0,19.0,66,513
Sonoma,95442,2021,158,1118,105.0,37.0,142,1276
Sonoma,95444,2021,29,257,25.0,4.0,29,286
Mendocino,95445,2021,142,1019,119.0,43.0,162,1161
Sonoma,95446,2021,408,2475,308.0,179.0,487,2883
Sonoma,95448,2021,647,5020,505.0,112.0,617,5667
Mendocino,95449,2021,61,282,34.0,5.0,39,343
Sonoma,95450,2021,29,255,30.0,12.0,42,284
Lake,95451,2021,534,4046,509.0,151.0,660,4580
Sonoma,95452,2021,73,612,65.0,15.0,80,685
Lake,95457,2021,106,1023,122.0,31.0,153,1129
Lake,95461,2021,99,1004,102.0,24.0,126,1103
Sonoma,95462,2021,126,806,103.0,34.0,137,932
Sonoma,95465,2021,74,571,38.0,26.0,64,645
Lake,95467,2021,384,2164,282.0,95.0,377,2548
Sonoma,95471,2021,29,128,20.0,6.0,26,157
Sonoma,95472,2021,866,9061,699.0,176.0,875,9927
Sonoma,95476,2021,1362,10649,1117.0,232.0,1349,12011
Sonoma,95486,2021,5,51,7.0,1.0,8,56
Sonoma,95492,2021,899,8098,809.0,147.0,956,8997
Sonoma,95497,2021,207,1101,133.0,27.0,160,1308
Yolo,95606,2021,9,30,5.0,3.0,8,39
Yolo,95607,2021,6,62,6.0,2.0,8,68
Yolo,95616,2021,780,8330,674.0,94.0,768,9110
Solano,95620,2021,888,5161,626.0,67.0,693,6049
Solano,95625,2021,2,60,1.0,1.0,2,62
Yolo,95627,2021,115,846,92.0,27.0,119,961
Yolo,95637,2021,21,81,14.0,2.0,16,102
Yolo,95653,2021,9,104,11.0,4.0,15,113
Yolo,95679,2021,3,13,1.0,0.0,1,16
Solano,95687,2021,2412,16512,1949.0,233.0,2182,18924
Solano,95688,2021,1331,10735,1205.0,133.0,1338,12066
Yolo,95694,2021,418,2230,227.0,61.0,288,2648
Yolo,95695,2021,941,8611,822.0,176.0,998,9552
Yolo,95697,2021,8,69,6.0,1.0,7,77
Yolo,95698,2021,13,47,9.0,3.0,12,60
Colusa,95912,2021,146,1015,114.0,34.0,148,1161
Colusa,95932,2021,237,1715,174.0,44.0,218,1952
Yolo,95937,2021,47,251,31.0,6.0,37,298
Colusa,95979,2021,36,228,26.0,8.0,34,264
Colusa,95987,2021,155,1189,106.0,29.0,135,1344
Napa,94503,2020,532,4928,,,497,5460
Napa,94503,2021,557,4874,,,547,5431
Napa,94503,2022,447,4882,,,471,5329
Napa,94508,2020,41,672,,,53,713
Napa,94508,2021,57,633,,,100,690
Napa,94508,2022,62,540,,,135,602
Solano,94510,2020,691,7639,,,679,8330
Solano,94510,2021,795,7509,,,806,8304
Solano,94510,2022,622,7561,,,606,8183
Solano,94512,2020,4,25,,,3,29
Solano,94512,2021,4,25,,,4,29
Solano,94512,2022,0,25,,,3,25
Napa,94515,2020,273,1942,,,221,2215
Napa,94515,2021,245,1946,,,227,2191
Napa,94515,2022,234,1899,,,262,2133
Solano,94533,2020,2140,16203,,,1763,18343
Solano,94533,2021,2390,16219,,,2018,18609
Solano,94533,2022,1938,16629,,,1742,18567
Solano,94534,2020,1385,11652,,,1234,13037
Solano,94534,2021,1691,11528,,,1558,13219
Solano,94534,2022,1342,11661,,,1307,13003
Solano,94535,2020,0,6,,,1,6
Solano,94535,2021,0,4,,,1,4
Solano,94535,2022,0,4,,,1,4
Napa,94558,2020,1731,17802,,,1621,19533
Napa,94558,2021,1934,17621,,,1878,19555
Napa,94558,2022,1745,17391,,,1806,19136
Napa,94559,2020,675,6569,,,583,7244
Napa,94559,2021,760,6496,,,743,7256
Napa,94559,2022,642,6507,,,628,7149
Napa,94562,2020,0,8,,,0,8
Napa,94562,2021,2,8,,,1,10
Napa,94562,2022,0,7,,,3,7
Napa,94567,2020,5,113,,,5,118
Napa,94567,2021,4,108,,,9,112
Napa,94567,2022,17,92,,,29,109
Solano,94571,2020,628,4427,,,537,5055
Solano,94571,2021,952,4597,,,628,5549
Solano,94571,2022,645,4514,,,509,5159
Napa,94573,2020,3,31,,,5,34
Napa,94573,2021,1,34,,,4,35
Napa,94573,2022,2,29,,,4,31
Napa,94574,2020,247,2361,,,234,2608
Napa,94574,2021,279,2321,,,294,2600
Napa,94574,2022,282,2150,,,397,2432
Napa,94576,2020,0,62,,,1,62
Napa,94576,2021,5,42,,,6,47
Napa,94576,2022,6,38,,,8,44
Solano,94585,2020,843,7491,,,758,8334
Solano,94585,2021,1003,7475,,,929,8478
Solano,94585,2022,711,7452,,,786,8163
Solano,94591,2020,1574,14876,,,1492,16450
Solano,94591,2021,1917,14561,,,1828,16478
Solano,94591,2022,1540,14742,,,1576,16282
Napa,94599,2020,111,764,,,93,875
Napa,94599,2021,104,773,,,106,877
Napa,94599,2022,91,771,,,86,862
Sonoma,95401,2020,821,8534,,,749,9355
Sonoma,95401,2021,1138,8571,,,954,9709
Sonoma,95401,2022,830,8489,,,884,9319
Sonoma,95403,2020,1299,9665,,,1016,10964
Sonoma,95403,2021,1475,9777,,,1122,11252
Sonoma,95403,2022,1186,10042,,,947,11228
Sonoma,95404,2020,1230,10697,,,1119,11927
Sonoma,95404,2021,1298,10674,,,1300,11972
Sonoma,95404,2022,1143,10493,,,1243,11636
Sonoma,95405,2020,595,6235,,,573,6830
Sonoma,95405,2021,656,6193,,,629,6849
Sonoma,95405,2022,578,6132,,,595,6710
Sonoma,95409,2020,950,8369,,,845,9319
Sonoma,95409,2021,1228,8281,,,1114,9509
Sonoma,95409,2022,1061,8296,,,1050,9357
Sonoma,95412,2020,9,80,,,9,89
Sonoma,95412,2021,5,76,,,12,81
Sonoma,95412,2022,8,68,,,10,76
Sonoma,95416,2020,7,13,,,2,20
Sonoma,95416,2021,2,12,,,5,14
Sonoma,95416,2022,0,11,,,0,11
Sonoma,95419,2020,33,247,,,30,280
Sonoma,95419,2021,57,232,,,45,289
Sonoma,95419,2022,57,221,,,59,278
Sonoma,95421,2020,50,721,,,56,771
Sonoma,95421,2021,81,698,,,75,779
Sonoma,95421,2022,74,672,,,91,746
Lake,95422,2020,638,4384,,,599,5022
Lake,95422,2021,586,4348,,,612,4934
Lake,95422,2022,467,4310,,,492,4777
Lake,95423,2020,266,1785,,,240,2051
Lake,95423,2021,264,1777,,,260,2041
Lake,95423,2022,202,1739,,,254,1941
Lake,95424,2020,8,121,,,20,129
Lake,95424,2021,5,132,,,13,137
Lake,95424,2022,5,122,,,13,127
Sonoma,95425,2020,336,3146,,,299,3482
Sonoma,95425,2021,422,3113,,,395,3535
Sonoma,95425,2022,384,3048,,,388,3432
Lake,95426,2020,85,703,,,79,788
Lake,95426,2021,60,679,,,84,739
Lake,95426,2022,82,561,,,154,643
Sonoma,95430,2020,4,65,,,3,69
Sonoma,95430,2021,2,63,,,4,65
Sonoma,95430,2022,5,56,,,10,61
Sonoma,95433,2020,4,37,,,2,41
Sonoma,95433,2021,3,42,,,4,45
Sonoma,95433,2022,1,31,,,3,32
Sonoma,95436,2020,220,2155,,,180,2375
Sonoma,95436,2021,267,2123,,,255,2390
Sonoma,95436,2022,239,2031,,,283,2270
Sonoma,95439,2020,16,164,,,7,180
Sonoma,95439,2021,13,171,,,13,184
Sonoma,95439,2022,14,169,,,24,183
Sonoma,95441,2020,48,411,,,35,459
Sonoma,95441,2021,81,420,,,57,501
Sonoma,95441,2022,72,413,,,68,485
Sonoma,95442,2020,127,1096,,,125,1223
Sonoma,95442,2021,153,1090,,,125,1243
Sonoma,95442,2022,248,978,,,247,1226
Sonoma,95444,2020,31,243,,,19,274
Sonoma,95444,2021,28,246,,,24,274
Sonoma,95444,2022,27,247,,,27,274
Mendocino,95445,2020,110,1018,,,114,1128
Mendocino,95445,2021,123,987,,,143,1110
Mendocino,95445,2022,105,946,,,137,1051
Sonoma,95446,2020,314,2536,,,242,2850
Sonoma,95446,2021,381,2430,,,383,2811
Sonoma,95446,2022,314,2218,,,479,2532
Sonoma,95448,2020,472,4912,,,433,5384
Sonoma,95448,2021,617,4900,,,537,5517
Sonoma,95448,2022,655,4761,,,598,5416
Mendocino,95449,2020,45,252,,,33,297
Mendocino,95449,2021,59,266,,,32,325
Mendocino,95449,2022,34,281,,,39,315
Sonoma,95450,2020,29,231,,,27,260
Sonoma,95450,2021,21,235,,,28,256
Sonoma,95450,2022,17,213,,,32,230
Lake,95451,2020,460,3728,,,480,4188
Lake,95451,2021,365,3657,,,474,4022
Lake,95451,2022,326,3569,,,386,3895
Sonoma,95452,2020,60,595,,,54,655
Sonoma,95452,2021,70,606,,,66,676
Sonoma,95452,2022,85,551,,,90,636
Lake,95457,2020,99,1001,,,110,1100
Lake,95457,2021,77,972,,,114,1049
Lake,95457,2022,61,930,,,114,991
Lake,95461,2020,98,977,,,84,1075
Lake,95461,2021,84,979,,,98,1063
Lake,95461,2022,87,854,,,177,941
Sonoma,95462,2020,101,802,,,106,903
Sonoma,95462,2021,117,792,,,115,909
Sonoma,95462,2022,124,702,,,174,826
Sonoma,95465,2020,61,566,,,57,627
Sonoma,95465,2021,72,563,,,54,635
Sonoma,95465,2022,83,530,,,102,613
Lake,95467,2020,305,2181,,,268,2486
Lake,95467,2021,328,2144,,,311,2472
Lake,95467,2022,309,2036,,,367,2345
Sonoma,95471,2020,23,105,,,25,128
Sonoma,95471,2021,25,130,,,25,155
Sonoma,95471,2022,16,137,,,24,153
Sonoma,95472,2020,915,8996,,,770,9911
Sonoma,95472,2021,858,8998,,,787,9856
Sonoma,95472,2022,916,8931,,,828,9847
Sonoma,95476,2020,1223,10636,,,1117,11859
Sonoma,95476,2021,1350,10536,,,1240,11886
Sonoma,95476,2022,1237,10419,,,1248,11656
Sonoma,95486,2020,3,55,,,2,58
Sonoma,95486,2021,5,52,,,7,57
Sonoma,95486,2022,4,47,,,10,51
Sonoma,95492,2020,812,8151,,,723,8963
Sonoma,95492,2021,904,8070,,,875,8974
Sonoma,95492,2022,712,8039,,,767,8751
Sonoma,95497,2020,201,1229,,,173,1430
Sonoma,95497,2021,196,1223,,,165,1419
Sonoma,95497,2022,195,1194,,,188,1389
Yolo,95606,2020,7,30,,,6,37
Yolo,95606,2021,8,30,,,8,38
Yolo,95606,2022,2,34,,,3,36
Yolo,95607,2020,9,60,,,15,69
Yolo,95607,2021,5,63,,,12,68
Yolo,95607,2022,12,56,,,19,68
Yolo,95616,2020,656,8290,,,617,8946
Yolo,95616,2021,788,8310,,,725,9098
Yolo,95616,2022,576,8253,,,576,8829
Solano,95620,2020,728,5019,,,557,5747
Solano,95620,2021,865,5148,,,625,6013
Solano,95620,2022,845,5373,,,548,6218
Solano,95625,2020,10,49,,,12,59
Solano,95625,2021,2,65,,,1,67
Solano,95625,2022,6,64,,,4,70
Yolo,95627,2020,82,870,,,86,952
Yolo,95627,2021,117,842,,,112,959
Yolo,95627,2022,92,838,,,120,930
Yolo,95637,2020,15,70,,,14,85
Yolo,95637,2021,16,79,,,14,95
Yolo,95637,2022,24,76,,,13,100
Yolo,95653,2020,13,108,,,14,121
Yolo,95653,2021,9,109,,,12,118
Yolo,95653,2022,12,103,,,12,115
Yolo,95679,2020,4,15,,,5,19
Yolo,95679,2021,4,13,,,2,17
Yolo,95679,2022,7,17,,,1,24
Solano,95687,2020,2222,16323,,,1728,18545
Solano,95687,2021,2378,16519,,,2023,18897
Solano,95687,2022,1973,16842,,,1793,18815
Solano,95688,2020,1385,10595,,,1200,11980
Solano,95688,2021,1321,10734,,,1215,12055
Solano,95688,2022,1202,10703,,,1168,11905
Yolo,95694,2020,313,2154,,,202,2467
Yolo,95694,2021,416,2230,,,278,2646
Yolo,95694,2022,347,2318,,,289,2665
Yolo,95695,2020,853,8635,,,775,9488
Yolo,95695,2021,944,8569,,,951,9513
Yolo,95695,2022,761,8616,,,735,9377
Yolo,95697,2020,10,69,,,5,79
Yolo,95697,2021,8,72,,,6,80
Yolo,95697,2022,12,69,,,33,81
Yolo,95698,2020,5,47,,,3,52
Yolo,95698,2021,13,47,,,12,60
Yolo,95698,2022,3,52,,,5,55
Colusa,95912,2020,131,916,,,111,1047
Colusa,95912,2021,136,959,,,118,1095
Colusa,95912,2022,89,953,,,108,1042
Colusa,95932,2020,238,1707,,,202,1945
Colusa,95932,2021,234,1711,,,210,1945
Colusa,95932,2022,215,1735,,,185,1950
Yolo,95937,2020,50,296,,,28,346
Yolo,95937,2021,58,295,,,44,353
Yolo,95937,2022,43,322,,,40,365
Colusa,95979,2020,25,224,,,17,249
Colusa,95979,2021,36,215,,,30,251
Colusa,95979,2022,41,219,,,35,260
Colusa,95987,2020,134,1162,,,102,1296
Colusa,95987,2021,159,1182,,,132,1341
Colusa,95987,2022,123,1181,,,117,1304
